##############################################################################################################################################################################################################
#........................................................................................................................................^....................................................................
#...............................^...........................................................................................................................................................#.................
#......................^.........................................................................................#............................................................................................
#.............^..................................................................................................>......................................................#.....................................
#....^...................................................#..............................................................................................^.....................................................
#..................................:..........................................................................................................................................................................
#..........................................<............................###....####..............................................####..###..####......................................<.......................
#..............................#############.......;..............######..*.*.*....................................<##########.*................####.............................######.......................
#.@...........<............................>.............#########.................................<.......###########.............<<<<<<<<<<<<<<<...###.........<...........####<<<...................<......
##############################################################################################################################################################################################################
