######################################################################################################################################################################################################################
#................................<................................................................................................................................*................##.................................
#.........................^......>.................................................................................................................................................##.................................
#....................<...................^..............................................................................................#.......................<..................*..................................
#...........^........>..........................................................................................................................................>...................................<.................
#..<..........................................................................................................................................#.......^..............<....................<.........#.................
#..>.......................................................................................<........<.......;.....:..................................................>....................#.........>.................
#...........................<........<.####................<...........................#####..#######................................<....................................................>...........................
#.....................#######..#######.....#........<.######..#####.....<.###*.#####........%........#########<##########....#########*.........................<.......:.............................................
#.@............<<##<<<#<<<<<<<<<<<<<<<......#########...............######.............................................<<<<<<<<...........######............#####........................................<............
######################################################################################################################################################################################################################
